###S#####################
###..#....#..###.#.#.#.##
##..#.#.#...#.#..#...#..#
#..#..##..#....#...#.#.##
#.#..#..##.##.#..##.#...#
#..#..#.....#..#....#.#.#
#.#..#.#.#.#..##.##.#..##
#.#.#..#.#..#......#..###
#....#..#..#..#.#.#.#..##
##.##.#.#.#..###.#...#..#
#...#.....##..#...##.#.##
#.#.#.###..#.#..###.....#
##..##....#..#.#....#.#.#
###..#.##..#....#.##.#.##
##.#..#...#..#.#...#....#
#...#.##.#.#..#..###.##.#
##.#...#....#.#.#....#..#
#..#.#..###......#.#..#.#
##.#.##.#..#.#.#....#..##
#...#...##..#..##.#.#.#.#
##.#.##...#...#.##...#..#
#.....#.#...#.#..####..##
#.##.#.#.#.#.#.#....#.#.#
##...............##.....#
#######################E#
